NO ./textures/wall_1.xpm
EA ./textures/wall_2.xpm
SO ./textures/wall_3.xpm
WE ./textures/wall_4.xpm

F 0,255,0
C 0,0,255,2134, 1234, 123 12

  1111111
  1N0  01
111  0 1
1     01
11111111
